▤▤▤▤▤▤▤▤▤▤▤▤▤▤▤▤▤▤▤▤▤▤▤▤▤▤▤▤▤▤▤▤▤▤▤▤▤▤▤▤▤▤▤▤▤▤▤▤▤▤▤▤▤▤▤▤▤▤▤▤▤▤▤▤▤▤▤▤▤▤▤▤▤▤▤▤▤▤▤▤
▤♣♣♣♣♣♣♣♣♣♣♣♣♣♣▤             ▤             ☠  ▤   ▤▤     ▤      ▤   ▤   ▤    ▤▤
▤♣♣♣▤▤▤▤                     ▤                            ▤                    ▤
▤♣♣♣▤▤▤▤  ☠                                                 ▤▤▤▤▤▤▤▤▤▤▤▤▤▤▤▤▤▤▤
▤                            ▤             ♣              ▤                    ▤
▤♣♣♣                         ▤             ♣                                   ▤
▤♣♣♣♣    ▤▤▤▤▤▤▤▤            ▤                            ▤                    ▤
▤ ♣♣♣♣   ▤      ▤            ▤               ☠           ▤                    ▤
▤  ♣     ▤      ▤            ▤                            ▤     ♣♣♣♣♣♣♣♣♣♣♣♣♣♣♣▤
▤        ▤      ▤▤▤▤▤▤▤▤▤▤▤  ▤                            ▤       ♣♣♣♣♣♣♣♣♣♣♣♣♣▤
▤   ☺♣   ▤                   ▤               ☠            ▤                    ▤
▤        ▤                   ▤                            ▤                    ▤
▤        ▤▤▤▤▤▤▤▤▤▤▤▤▤▤▤▤▤▤▤▤▤                            ▤                    ▤
▤                            ▤                                                  ▤
▤                  ♣♣♣       ▤                                                  ▤
▤                   ♣        ▤                                                  ▤
▤  ▤▤▤▤▤▤▤▤▤▤▤▤▤▤▤▤▤▤▤▤▤▤▤   ▤                            ▤                    ▤
▤  ▤                     ▤   ▤                            ▤                    ▤
▤  ▤     ☠                ☠                              ▤                    ▤
▤  ▤                                                    ▤▤▤▤▤▤▤▤▤▤▤▤▤▤▤▤▤▤▤▤ ▤
▤  ▤                     ▤▤▤▤▤                            ▤       ♣♣♣♣♣♣♣♣♣♣♣♣♣▤
▤  ▤                         ▤                            ▤      ♣♣♣♣♣♣♣♣♣♣♣♣♣♣▤
▤  ▤                         ▤                            ▤    ♣♣♣♣♣♣♣♣♣♣♣♣♣♣♣♣▤
▤  ▤  ▤▤▤▤▤▤▤▤▤▤▤▤▤▤▤▤▤▤▤▤▤▤▤▤            ♣♣♣♣♣♣    ☠    ▤   ♣♣♣♣♣♣♣♣♣♣♣♣♣♣♣♣♣▤
▤  ▤                         ▤             ♣♣♣♣           ▤♣♣♣♣♣♣♣♣♣♣♣♣♣♣♣♣♣♣♣♣▤
▤  ▤                         ▤                            ▤♣♣♣♣♣♣♣♣♣♣♣♣♣♣♣♣♣♣♣♣▤
▤  ▤          ☠             ▤                            ▤♣♣♣♣♣♣♣♣♣♣♣♣♣♣♣♣♣♣♣♣▤
▤  ▤                         ▤                            ▤♣♣♣♣♣♣♣♣♣♣♣♣♣♣♣♣♣♣♣♣▤
▤                            ▤                            ▤♣♣♣♣♣♣♣♣♣♣♣♣♣♣♣♣♣♣♣♣▤
▤▤▤▤▤▤▤▤▤▤▤▤▤▤▤▤▤▤▤▤▤▤▤▤▤▤▤▤▤▤▤▤▤▤▤▤▤▤▤▤▤▤▤▤▤▤▤▤▤▤▤▤▤▤▤▤▤▤▤▤▤▤▤▤▤▤▤▤▤▤▤▤▤▤▤▤▤▤▤▤